40 40
12 12 12 12 12 12 12 12 12 12 12 12 12 12 12 12 12 12 12 12 12 12 12 12 12 12 12 12 12 12 12 12 12 12 12 12 12 12 12 12
13 00 00 00 00 00 00 00 00 00 00 00 00 00 00 00 00 00 00 00 00 00 00 00 00 00 00 00 00 00 00 00 00 00 00 00 00 00 00 13
13 00 00 00 00 00 00 00 00 00 00 00 00 00 00 00 00 00 30 30 30 00 00 00 00 00 00 00 00 00 00 00 00 00 00 00 00 00 00 13
13 00 00 00 00 00 00 00 00 00 00 00 00 00 19 30 30 30 30 30 30 30 30 30 30 00 14 11 12 12 14 19 00 00 00 00 00 00 00 13
13 00 19 00 00 00 00 00 00 00 00 00 00 00 00 30 30 30 30 30 30 30 30 30 30 00 13 01 01 01 13 00 00 00 00 00 00 00 00 13
13 00 00 00 00 00 00 00 00 00 00 19 00 00 30 30 30 30 00 00 30 30 30 30 30 00 13 01 01 01 13 00 00 19 00 00 00 00 00 13
13 00 00 00 19 00 00 00 00 00 00 00 00 00 30 30 30 30 00 00 30 30 30 19 00 00 13 01 01 01 13 00 00 00 00 00 00 00 00 13
13 00 00 00 00 00 00 00 00 00 00 00 00 00 00 30 30 30 30 30 30 30 30 00 00 00 13 01 01 01 13 00 00 00 00 00 00 00 00 13
13 00 00 00 00 21 00 00 19 00 00 00 00 00 00 00 30 30 30 30 00 00 00 00 00 00 13 01 01 01 13 00 00 00 00 00 00 00 00 13
13 00 00 00 00 00 00 00 00 00 00 00 00 00 00 00 00 30 30 00 00 00 00 00 00 19 13 01 01 01 13 00 00 00 00 00 00 00 00 13
13 00 19 00 00 00 00 00 00 00 00 00 00 00 00 00 00 30 30 00 00 00 19 00 00 00 13 01 01 01 13 00 00 00 19 00 00 00 00 13
13 00 00 00 00 00 00 00 00 00 00 00 00 00 00 19 00 30 30 19 00 00 00 00 00 00 13 01 01 01 13 00 00 00 00 00 00 00 00 13
13 00 19 00 00 00 00 00 00 00 00 00 02 02 02 02 20 20 20 02 02 02 02 00 00 00 14 12 12 11 14 00 00 00 00 00 00 00 00 13
13 00 00 19 00 00 00 00 00 00 19 00 02 00 00 00 00 30 30 00 00 00 02 02 02 02 02 02 02 02 02 19 00 00 00 00 00 00 00 13
13 00 19 00 00 00 00 00 00 00 02 02 02 00 00 00 00 30 30 00 19 00 00 00 00 00 20 00 00 00 02 00 00 00 00 00 00 00 00 13
13 00 00 00 00 00 00 00 14 12 11 12 12 12 12 12 12 12 12 12 12 12 12 12 12 12 11 12 14 00 02 00 19 00 00 00 00 00 00 13
13 00 00 00 00 19 00 00 13 01 01 01 01 01 01 01 01 01 01 01 01 01 01 01 01 01 01 01 13 00 02 00 00 00 00 00 19 00 00 13
13 19 00 00 00 00 00 00 13 01 01 01 01 01 01 01 01 01 01 01 01 01 01 01 01 01 01 01 13 00 02 00 00 00 00 00 00 00 00 13
13 00 00 00 19 00 00 00 13 01 01 01 01 01 01 01 01 01 01 01 01 01 01 01 01 01 01 01 13 00 02 02 00 00 00 00 00 00 00 13
13 00 19 00 00 00 00 00 13 01 01 01 01 01 01 01 01 01 01 01 01 01 01 01 01 01 01 01 13 00 02 02 00 00 00 00 00 00 00 13
13 00 00 00 00 00 00 00 13 01 54 51 55 01 01 01 01 01 01 01 01 01 01 01 01 01 01 01 13 00 00 02 00 00 00 00 00 00 00 13
13 00 00 19 00 00 00 00 13 01 54 52 55 01 01 01 01 01 01 01 01 01 01 01 01 01 01 01 13 00 00 02 00 00 00 19 00 00 00 13
13 00 00 00 00 00 00 00 13 01 54 52 55 01 01 14 12 12 11 12 14 01 01 01 01 01 01 01 13 00 00 02 00 00 00 00 00 00 00 13
13 00 19 00 00 19 19 00 13 01 54 53 55 01 01 13 20 20 20 20 13 01 01 01 01 01 01 01 13 00 00 02 00 00 00 00 00 00 00 13
13 19 00 00 00 00 00 00 13 01 01 01 01 01 01 13 20 20 20 20 13 01 01 01 01 01 01 01 13 00 00 02 00 00 00 00 00 00 00 13
13 00 19 00 19 00 00 19 13 01 01 01 01 01 01 13 20 20 20 20 13 01 01 01 01 01 01 01 13 00 00 02 00 00 00 00 00 00 00 13
13 00 00 00 00 19 00 00 13 01 01 01 01 01 01 13 20 20 20 20 13 01 01 01 01 01 01 01 13 19 02 02 19 00 00 00 19 00 00 13
13 00 00 00 00 00 00 00 13 01 01 01 01 01 01 13 20 20 20 20 13 01 01 01 01 01 01 01 13 02 02 00 00 00 00 00 00 00 00 13
13 00 00 00 19 00 19 00 14 12 12 12 12 12 12 14 20 20 20 20 14 12 12 12 12 12 12 12 14 02 00 00 00 00 00 00 00 00 00 13
13 19 00 00 00 00 00 00 00 00 00 00 00 00 00 00 20 20 20 20 00 00 00 00 00 00 00 02 00 02 00 00 00 00 00 00 00 00 00 13
13 00 00 00 00 00 19 00 00 00 00 00 00 00 00 19 00 02 02 00 00 19 00 00 00 00 19 02 02 02 00 00 00 00 00 00 00 00 00 13
13 00 00 00 00 00 00 00 00 00 00 00 19 00 00 00 00 02 02 02 02 02 02 19 00 02 02 02 00 00 00 00 00 00 00 00 00 00 00 13
13 00 00 19 19 00 00 19 00 00 00 00 00 00 00 00 19 02 02 02 19 00 02 02 02 02 00 00 00 00 00 00 00 00 00 00 00 19 00 13
13 00 00 00 00 00 00 00 00 00 00 00 00 00 00 00 00 02 02 00 00 00 00 00 00 00 00 00 00 00 00 00 00 19 00 00 00 00 00 13
13 00 19 00 00 00 00 00 00 00 00 00 00 00 00 00 00 02 02 00 00 00 19 00 00 00 00 00 00 00 00 00 00 00 00 00 00 00 00 13
13 00 00 00 00 19 00 00 00 00 00 00 00 00 00 19 00 02 02 19 00 00 00 00 00 19 00 00 00 19 00 00 00 00 00 00 00 00 00 13
13 00 00 00 00 00 00 00 00 19 00 00 00 00 00 00 00 02 02 00 00 00 00 00 00 00 00 00 00 00 00 00 00 00 00 00 00 00 00 13
13 00 00 00 00 00 00 00 00 00 00 00 00 00 00 00 19 02 02 00 00 19 00 00 00 00 00 00 00 00 00 00 00 00 00 00 00 00 00 13
13 00 00 00 00 00 00 00 00 00 00 00 00 00 00 00 00 02 02 00 00 00 00 00 00 00 00 00 00 00 00 00 00 00 00 00 00 00 00 13
12 12 12 12 12 12 12 12 12 12 12 12 12 12 12 12 12 11 11 12 12 12 12 12 12 12 12 12 12 12 12 12 12 12 12 12 12 12 12 12